11111111111111111111111111111
10000000010000100000000010001
10100010010000000000000000E01
1000P000C00000100000000011111
10100000010000000000000000001
10000010000000100000000000001
10000000010000000000001100001
10010000010000100000001100001
10010000010000100000001110001
100100000100001000000011C0001
10010000010000100000001110001
10010000010000100000001100001
1C0000000000000C0000000000001
11111111111111111111111111111
