111111111111111
10C100001C00001
1100011010000P1
101010000010001
101000100100001
111100C00000001
1E0011000000011
110000001000001
110C00000100001
111111111111111
