1111111111111
101001100C001
1C000000100P1
100110110C101
110100C000101
1000E11110001
110000000C001
1111111111111
