111111111111111
10C100001000001
1100000010000P1
101000000C00001
101001100000001
111100C00000001
1E0010000000001
110000001000001
110000000C00001
111111111111111
