1111111111111
1C0110000C001
10100000100P1
100000000C001
111100C000001
1E00100000001
110000000C001
1111111111111
