1111111111111
1000000P00001
1000000000001
100000C0000E1
1000000000101
1111111111111
