1111111111111
10C1000P00001
110000C000001
1E00100000001
1000C10000001
1111111111111
