1111111111111
1000000P00001
1000000000001
1E00000000001
10000000P0001
1111111111111
