1111111111111
10C0000P00001
100000C000001
1E00100000001
1001C10000001
1111111111111
