1111111111111
1000000P00001
100000C000001
1E00000000001
1000000000001
1111111111111
