

1111111111111
101000000C001
11000000100P1
101000000C001
111100C000001
1E00100000001
110000000C001
1111111111111
