111111111111111
10C100001C111C1
1P0000001000001
101010C00100001
1C1001111100001
111100C00110001
1E0000001000001
1011100010000C1
100000000000001
111111111111111

