
111111111111111
10C111111C111C1
1P0011001000001
101010C00100001
1C1001111100001
111100C00110001
1E001C011100001
101111001000001
100000001000001
111111111111111
