111111111111111
10C100001C111C1
1P0001100000001
101010C01100001
1C1011111000001
111100C00110001
110000000000001
1011110010000C1
1E0000001000001
111111111111111
