111111111111111
110111111101111
101110000C00101
111100C01100001
1E0011111000001
110011000C11111
111111111111111
